1111111
1P00001
1000111
1E001C1
1111111
