1111111
1P00001
1000001
1C000E1
1111110
