1111111
1P00001
1000001
1C00001
1111111
