1111111111111111
10CCCC00100CCCC1
10000000C0011111
10000000000CCCC1
1011111001000001
10111010010CCCC1
10111000010CCCC1
10P1E000010CCCC1
1111111111111111
