111111111111
100001000001
101111C001C1
100000011111
10C110000101
1001P00001E1
10010001C001
111111111111
