111111111111111111111111111111111111111111111111111111111111
1111111111110CCCCCCCCCC0111111111000000CCCCCCCCCCCCCCCCCCCC1
1111111111110CCCCCCCCCC0111111111000000CCCCCCCCCCCCCCCCCCCC1
1111E11111110CCCCCCCCCC0111111111000000CCCCCCCCCCCCCCCCCCCC1
100000000000000000000000000000000000000CCCCCCCCCCCCCCCCCCCC1
100000000000000000000000000000000000000CCCCCCCCCCCCCCCCCCCC1
100000000000000000000000000000000000000000000000000000000001
100000000000000000000000000000000000000000000000000000000001
100000000000000000000000000000000000000000000000000000000001
100000000000000000000000000000000000000000000000000000000001
100000000000000000000000000000000000000000000000000000000001
100000000000000000000000000000000000000000000000000000000001
100000000000000000000000000000000000000000000000000000000001
1111111000011111110000000000P0000000000000000000000000000001
1CCCCC000000CCCCC1000000000000000000000000000000000000000001
1CCCCC000000CCCCC1000000000000000000000000000000000000000001
1CCCCC000000CCCCC1000000000000000000000000000000CCCCCCCCCCC1
1CCCCC000000CCCCC1000000000000000000000000000000CCCCCCCCCCC1
1CCCCCCCCCCCCCCCC1000000000000000000000000000000CCCCCCCCCCC1
1CCCCCCCCCCCCCCCC1000000000000000000000000000000CCCCCCCCCCC1
1CCCCCCCCCCCCCCCC1000000000000000000000000000000CCCCCCCCCCC1
111111111111111111000000000000000000000000000000CCCCCCCCCCC1  
100000000000000000000000000000001111111111111111111111111111
100000000000000000000000000000001CCCCCCCCCCCCCCCCCCCCCCCCCC1
100000000000000000000000000000001CCCCCCCCCCCCCCCCCCCCCCCCCC1
100000000000000000000000000000001CCCCCCCCCCCCCCCCCCCCCCCCCC1
111110010000000000000000000000000000000000000000000000000001
1CCCCCC10000000000000000000000000000000000000000000000000001
CCCCCCC10000000000000000000000001CCCCCCCCCCCCCCCCCCCCCCCCCC1
1CCCCCC10000000000000000000000001CCCCCCCCCCCCCCCCCCCCCCCCCC1
111111111111111111111111111111111111111111111111111111111111
