11111111
1000C1C1
10110101
1P1E00C1
11111111
